XXXXXXXXXXXXXXXXXXXXXXXXXX
XX  FXX E  XXXXX     E   X
XX XXXX XXXXXXXXXXXXX  XXX
X                        X
X                        X
X                        X
X                        X
X S       S     S        X
XXXXXXXXXXXXXXXXXXXXXXXXXX
